NO         ./sprits/Brick.xpm
SO        ./sprits/Circle.xpm
WE    ./sprits/wood.xpm
EA       ./sprits/Yellow.xpm
F 17,134,40
C 0,180,253




        1111111111111111111111111
        1000000000110000000000001
        1011000001110000000000001
        1001000000000000000000001
111111111011000001110000000000001
100000000011000001110111111011111
11110111111111011100000010001
11110111111111011101010010001
11000000110101011100000010001
10000000000000000000000010001
10000000000000001101010010001
11000001110101011111011010N011
11110111 1110101 101111000001
11111111 1111111 111111111111



