NO ./sprits/Brick.xpm
SO ./sprits/Circle.xpm
WE ./sprits/wood.xpm
EA ./sprits/Yellow.xpm

C 28,28,28
F 28,28,28

11111
1A001
10E01
10001
11111