NO ./textures/mini1.xpm
SO ./textures/mini1.xpm
WE ./textures/mini2.xpm
EA ./textures/mini2.xpm

F 17,134,40
C 0,180,253

1111111111111111111111111111111111111
1010000000100000001000001000000000101
1010111110101110111110111011101110101
1000000010001010000010000010101000101
1111101011111011111011101010101111101
1000101000000010000010101010100000101
1010111111101010111110111010111110101
1010000000101010001000001000001000101
1011111110111011101011101111101011101
1000001000101000101000100000101000001
1011101110101110101111101010101111111
1000100010101000100010001010100010001
1111111010101011111010111010111011101
1000001010000010001010001010001000001
1011101011111011101011101110111111101
1010001000001000001000101010000000101
1010111110101110111110101011111110101
1010000010101010100000100000001010001
1011111010101011101111101111101011111
1010001010100000100000101000100000001
1010111011101110111110111010111110101
1N10000000001000001000000010000000101
1111111111111111111111111111111111111