NO         ./sprits/Brick.xpm           
SO        ./sprits/Circle.xpm
WE    ./sprits/wood.xpm
EA       ./sprits/Yellow.xpm              
F  17,134,40
C  0,180,253

11111111111111111111111
10000000001100000000001
10110000011100000000001
10010000000000000000001
11011111101100011100001
10000001111111111101111
11110111       10001111
11111111    1101011
1111000011111111001111
10000000000001 10000001
10000000000001 1W101001
10000111110011111011111
1111011   1001   1011111
1111111   1111   11111111