
NO               ./sprites/Brick.xpm           
SO        ./sprites/Circle.xpm          
WE    ./sprites/wood.xpm
EA       ./sprites/Yellow.xpm                     
F  17,134,40
C  0,180,253

        1111111111111111111111111
        1000000000110000000000001
        1011000001110000000000001
        100100000000    000000001
111111111011000001110000000000001
10000011111111111111111111111111
 1000001
11110111111111111111111111111
11110111111111011101010010001
11000000110101011100000010001
10000000000111000000000010001
1000000N000000001101010010001            
11000001110101011111011010001
11110111 1110101 101111000001
11111111 1111111 111111111111
