NO         ./sprits/Brick.xpm
SO        ./sprits/Circle.xpm
WE    ./sprits/wood.xpm
EA       ./sprits/Yellow.xpm

F 17,134,40
C 0,180,253

          1111111111
          1000100001
          1000100001
          1000000001
          1000100001
11111111111111111101
10000000000000000101
10000000001000000101
10000000001000000001
10111111111111111111
10000000000000000001
10000000000000000001
11111111111111111101
10000000010000000001
10000000000000000001
10000000010000000001
11011111111111111111
10000000001000000001
10000000000000000W01
10000000001000000001
11111111111111111101
          1000000001
          1000000001
          1000000001
          1111111111
