
11111111111111111111
10000000000000000001
100000000N0000000001
10000000000000000001
10000100000000100001
10000100000000100001
10000100000000100001
10000100000000100001
10000100000000100001
10000100000000100001
10000000001000000001
10000000001000000001
10000000001000000001
10000000011119111101
10000000000000000001
11111111111111111111

